1111111111
1000101101
1P10000101
1C001CE011
1111111111
