11111111
10000001
10000011
11111111
