111111
100001
1C0001
1P0E01
111111
