11111111
1E0000P1
10000001
1S0000M1
11111111
