111111
1E0001
100001
1SC0P1
111111
