111111
1E0001
100001
10C0P1
111111
