111111
100001
100C01
1P0E01
111111
