111111
1000E1
1C0001
100001
111111
